4 4 4 4 4 4 4 3 3 1 1 1 1 1 1 1 1 1 1 1
6 0 0 0 0 0 0 0 0 0 0 0 0 0 0 0 0 0 0 3
6 0 0 0 0 0 0 0 0 0 0 0 0 0 0 0 0 0 3 3
6 3 0 0 0 4 4 4 0 0 0 0 3 2 2 2 0 0 0 2
6 0 0 0 0 0 4 0 0 0 0 3 0 0 0 0 0 6 0 2
5 0 0 0 0 0 4 4 4 0 0 0 0 0 0 0 0 6 0 2
5 0 0 3 0 0 0 0 0 0 0 0 0 0 1 1 1 6 0 2
5 5 0 0 0 0 0 0 0 0 0 6 0 0 0 0 0 4 4 4 
5 0 0 0 0 0 0 0 0 0 0 0 4 0 0 0 0 6 0 4
5 0 0 4 4 4 0 4 4 0 0 0 4 0 0 0 0 6 0 4
6 0 0 4 0 0 0 0 0 0 0 0 0 0 0 0 0 0 0 4
6 0 0 0 0 0 0 0 0 0 0 0 0 0 0 0 0 0 0 4
6 2 2 2 2 2 2 2 2 1 6 6 6 6 6 6 2 2 2 1
